nbLemmings 10
speed 1000
objective 5
blocker 1
bomber 1
carpenter 1
climber 1
digger 3
parachutist 5
tunneler 2
T V V V V V V V V V D I V I V V V V V V V V V V V V V I
V V V V V V V V V V D I V I V V V V V V V V V V V V V I
S V V V V V V V V V D I V I V V V V V V V V V V V V V I
V V V V V V V V D D D I V I V V V V V V V V V V V V V I
V V V V V D D D D V D I V I V V V V V V V V V V V V V I
V V V V E D V V V V D I V I V V V V V V V V V V V V V I
T D D D D D D D D D D I I I V V V V V V V V V V V V V I
V D D D D D D D D D D I V I D D D D D D D D D D D D V I
V V V V V V V V V V D I V I V V V V V V V V V V D D V I
V V V V V V V V V V D I V I V V V V V V V V V V D D V I
V V V V V V V V V V D I V I V V V V V V V V V V D D V I
V V V V V V V V D D D I V I V V V V V V V V V V D D V I
V V V V V D D D D V D I V I V V V V V V V V V V D D V I
V V V V V B V V V V D I V I V V V V V V V V V V I I I I
D D D D D D D D D D D I I I L L L L L L L L L L I I I I
D I I I I I I I I I I I I I L L L L L L L L L L I I I I